d . . . m . m . m m m . m m m
. m m . . . m . . . . . . . .
. . m . m m . . m m . m . m .
. m . . . . . m m m . m . m .
. . m m m m . m m . m . . . m
m . . . m m . . m . m m m . .
m . m . m m m m . . . . . m m
m . m . m . . . . m m m . m .
. . . m m . m m . m . . . m .
m . m m . . . . . m . m m m .
m . . . m m m m . m . . . . m
m m m . m . . . . m m m . . .
m . . . m . m m m m m m . . m
m . m m m . m . . . . . . . .
m . . . . . m m m . m m m m a
